#################################################................
#...............E...............................#................
#...............................................#................
#...............................................#################
#.....................................E.........................#							
#...............................................................#							
#....................P..........................................#
#......................................................W....... #
#...............................................................#
#...............................................................#
#############################....############...................#
.................#...............#..............................#
.................#...............#..............................#
.................#...............#..............................#
.................#...............#..............................#
.................################################################				