#################################################
#...............................................#
#...............................................#
#...............................................#
#...............................................#
#...............................................#
#....................P..........................#
#...............................................#
#...............................................#
#...............................................#
#################################################