#################################################
#...............E...............................#
#...............................................#
#...............................................#
#.....................................E.........#
#...............................................#
#....................P..........................#
#...............................................#
#...............................................#
#...............................................#
#################################################